state_name,district_name,fil_year,reg_year_date,total_cases,pending_cases,disposed_cases
Assam,Goalpara,2018,2018,21,14,7
Assam,Kokrajhar,2017,2017,28,11,17
Assam,Sonitpur,2017,2017,97,11,86
Assam,Kamrup,2015,2018,3,0,3
Haryana,Kaithal,2019,2019,52,34,18
Assam,Morigaon,2020,2020,29,26,3
Assam,Karbi Anglong,2017,2013,1,1,0
Assam,Karbi Anglong,2014,2014,8,6,2
Assam,Sonitpur,2014,2014,10,0,10
Haryana,Faridabad,2019,2020,15,15,0
Delhi,North West,2018,2019,1,1,0
Delhi,East,2015,2014,3,3,0
Assam,Chirang,2017,2017,18,1,17
Haryana,Faridabad,2018,2018,260,36,224
Assam,Morigaon,2018,2018,75,55,20
Haryana,Jhajjar,2018,2018,67,4,63
Delhi,East,2018,2018,156,153,3
Delhi,West,2017,2017,224,143,81
Delhi,South East,2018,2018,178,153,25
Delhi,Central,2014,2015,1,0,1
Delhi,South,2020,2019,1,1,0
Delhi,Shahdara,2019,2019,205,181,24
Assam,Tinsukia,2014,2014,1,0,1
Delhi,East,2020,2020,25,25,0
Assam,Lakhimpur,0   ,2014,1,0,1
Assam,Sivasagar,2015,2015,45,12,33
Assam,Karbi Anglong,2013,2014,1,1,0
Delhi,Shahdara,2018,2018,176,152,24
Haryana,Fatehabad,2016,2016,36,0,36
Haryana,Hisar,2018,2018,82,5,77
Assam,Karbi Anglong,2015,2014,1,0,1
Assam,Bongaigaon,2016,2016,7,0,7
Delhi,South West,2015,2015,49,43,6
Assam,Nalbari,0   ,2013,1,0,1
Assam,Karbi Anglong,2019,2019,60,53,7
Haryana,Sirsa,2017,2017,35,0,35
Delhi,South,2017,2017,134,93,41
Assam,Kamrup Metro,2017,2017,40,27,13
Haryana,Faridabad,2016,2016,85,0,85
Assam,Chirang,2020,2020,11,10,1
Assam,Lakhimpur,2015,2015,4,1,3
Assam,Sivasagar,2018,2018,53,31,22
Assam,Jorhat,2019,2019,64,55,9
Haryana,Jhajjar,2020,2020,7,7,0
Assam,Sonitpur,2015,2015,34,6,28
Assam,Sonitpur,2016,2016,54,10,44
Assam,Karbi Anglong,2018,2016,1,1,0
Assam,Kamrup Metro,2019,2019,87,84,3
Delhi,North West,2016,2016,179,77,102
Delhi,West,2012,2012,1,0,1
Assam,Dhubri,2014,2014,1,0,1
Delhi,South,2014,2015,62,38,24
Assam,Dhubri,2018,2018,68,17,51
Assam,Golaghat,2014,2014,9,4,5
Haryana,Fatehabad,2018,2018,78,19,59
Assam,Karimganj,2015,2015,9,3,6
Delhi,New Delhi,2017,2018,8,8,0
Haryana,Ambala,2016,2016,25,2,23
Delhi,Central,2013,2014,1,0,1
Delhi,West,2019,2013,1,0,1
Delhi,South,2013,2015,26,16,10
Delhi,North West,2014,2015,1,1,0
Assam,Kamrup,2016,2014,1,0,1
Assam,Karbi Anglong,2015,2015,16,8,8
Assam,Karbi Anglong,2016,2017,1,0,1
Delhi,Shahdara,2015,2015,39,35,4
Assam,Morigaon,2015,2015,18,2,16
Delhi,South West,2014,2014,34,19,15
Assam,Dibrugarh,2016,2016,68,13,55
Assam,Lakhimpur,2014,2014,1,0,1
Delhi,East,2017,2017,110,107,3
Assam,Udalguri,2020,2020,12,11,1
Haryana,Sirsa,2016,2016,35,0,35
Delhi,South,2020,2020,19,19,0
Assam,Dibrugarh,2017,2017,18,6,12
Assam,Karimganj,2014,2014,3,1,2
Delhi,New Delhi,2018,2019,2,1,1
Assam,Golaghat,2015,2015,17,6,11
Assam,Darrang,2020,2020,18,18,0
Delhi,North West,2020,2020,67,66,1
Assam,Sivasagar,2017,2017,91,19,72
Assam,Jorhat,2017,2017,18,3,15
Assam,Nalbari,2017,2017,41,9,32
Haryana,Panipat,2015,2015,9,0,9
Haryana,Fatehabad,2015,2015,27,0,27
Delhi,West,2015,2015,211,126,85
Delhi,North,2019,2020,1,1,0
Haryana,Sirsa,2018,2018,54,11,43
Haryana,Jhajjar,2019,2019,49,21,28
Assam,Udalguri,2016,2015,8,0,8
Assam,Barpeta,2016,2014,3,0,3
Haryana,Bhiwani,2020,2020,18,18,0
Haryana,Yamunanagar,2016,2016,6,0,6
Assam,Barpeta,2015,2015,4,0,4
Assam,Chirang,2018,2017,4,1,3
Assam,Kamrup,2016,2018,5,1,4
Haryana,Panipat,2020,2020,13,13,0
Haryana,Hisar,2017,2017,54,1,53
Assam,Jorhat,0   ,2015,2,0,2
Delhi,New Delhi,2016,2016,76,61,15
Assam,Cachar,0   ,2016,1,0,1
Assam,Kamrup Metro,2013,2013,1,0,1
Haryana,Rewari,2020,2020,20,19,1
Assam,Nalbari,2019,2019,58,50,8
Assam,Dhubri,0   ,2016,8,0,8
Delhi,East,2015,2015,59,53,6
Haryana,Kaithal,2016,2016,25,0,25
Assam,Karimganj,2019,2019,15,15,0
Assam,Dhubri,2016,2016,18,1,17
Delhi,Shahdara,2016,2016,68,63,5
Assam,Udalguri,2017,2017,19,4,15
Assam,Nagaon,2019,2019,73,69,4
Delhi,New Delhi,2017,2016,1,1,0
Haryana,Rewari,2019,2019,57,43,14
Assam,Golaghat,2015,2014,2,0,2
Haryana,Jhajjar,2014,2015,1,0,1
Assam,Chirang,2018,2018,25,1,24
Assam,Tinsukia,0   ,2015,4,0,4
Delhi,Central,2016,2014,1,0,1
Delhi,West,2013,2013,176,17,159
Haryana,Kurukshetra,2014,2014,6,0,6
Delhi,North West,2015,2013,1,0,1
Assam,Udalguri,2019,2019,58,39,19
Haryana,Gurugram,2015,2015,27,0,27
Assam,Barpeta,2017,2017,63,4,59
Haryana,Jind,2017,2017,53,7,46
Delhi,Central,2017,2017,156,108,48
Assam,Kamrup,2019,2019,69,61,8
Delhi,Central,2015,2015,107,48,59
Assam,Dhemaji,0   ,2015,11,2,9
Delhi,West,2014,2014,217,77,140
Assam,Dibrugarh,0   ,2014,1,0,1
Delhi,North,2016,2016,180,105,75
Assam,Dhemaji,2016,2016,15,1,14
Delhi,South East,2014,2014,26,15,11
Assam,Nalbari,2016,2016,15,1,14
Haryana,Rohtak,2018,2018,41,8,33
Assam,Chirang,2019,2019,37,22,15
Haryana,Palwal,2018,2018,74,15,59
Assam,Barpeta,2016,2017,2,0,2
Delhi,East,2014,2014,31,19,12
Assam,Nalbari,0   ,2014,1,0,1
Haryana,Bhiwani,2019,2019,18,13,5
Delhi,Central,2020,2020,32,32,0
Assam,Bongaigaon,2014,2015,1,1,0
Assam,Cachar,2018,2018,37,24,13
Haryana,Panipat,2016,2016,52,3,49
Delhi,North East,2017,2018,1,1,0
Assam,Barpeta,2016,2015,1,0,1
Assam,Hailakandi,2016,2016,1,0,1
Haryana,Jhajjar,2015,2015,43,1,42
Delhi,South,2015,2016,1,1,0
Haryana,Ambala,2014,2014,14,0,14
Assam,Goalpara,2017,2017,1,0,1
Assam,Golaghat,2020,2020,17,17,0
Assam,Kamrup,2017,2017,24,3,21
Haryana,Rohtak,2016,2016,46,1,45
Assam,Morigaon,2016,2016,29,11,18
Assam,Barpeta,2017,2018,1,0,1
Assam,Cachar,2016,2016,35,10,25
Assam,Kokrajhar,2018,2018,61,36,25
Assam,Nalbari,2014,2014,2,1,1
Assam,Nalbari,0   ,2015,1,0,1
Delhi,Central,2017,2018,1,1,0
Delhi,New Delhi,2013,2013,1,0,1
Assam,Dhemaji,0   ,2013,3,0,3
Haryana,Sonepat,2018,2018,72,12,60
Haryana,Jind,2019,2019,38,37,1
Assam,Kamrup,2015,2017,1,0,1
Delhi,East,2016,2016,69,68,1
Assam,Udalguri,2018,2018,37,7,30
Delhi,East,2013,2013,10,6,4
Haryana,Rewari,2016,2016,13,0,13
Delhi,North West,2014,2014,4,4,0
Delhi,North East,2020,2020,19,18,1
Assam,Baksa,2019,2019,61,56,5
Assam,Kokrajhar,2016,2016,9,3,6
Haryana,Ambala,2020,2020,13,13,0
Assam,Goalpara,2015,2015,1,0,1
Haryana,Faridabad,2020,2020,23,23,0
Delhi,Shahdara,2014,2014,22,9,13
Assam,Lakhimpur,2018,2018,14,6,8
Assam,Nalbari,2015,2015,10,6,4
Assam,Dibrugarh,2019,2019,1,1,0
Delhi,North,2018,2018,272,234,38
Assam,Lakhimpur,2013,2013,1,0,1
Delhi,South East,2020,2020,20,20,0
Haryana,Jhajjar,2014,2013,1,0,1
Haryana,Jind,2018,2018,85,40,45
Haryana,Sirsa,2015,2015,30,0,30
Assam,Kamrup,2016,2010,1,1,0
Assam,Karimganj,2018,2018,13,11,2
Assam,Kamrup Metro,2018,2018,90,79,11
Delhi,South West,2017,2017,192,109,83
Haryana,Panchkula,2015,2015,11,0,11
Assam,Hailakandi,2020,2020,11,11,0
Delhi,West,2019,2017,1,0,1
Assam,Dhemaji,0   ,2014,5,0,5
Delhi,South,2016,2016,93,80,13
Haryana,Fatehabad,2014,2014,1,0,1
Assam,Tinsukia,2017,2017,30,10,20
Haryana,Rewari,2015,2015,5,0,5
Assam,Barpeta,0   ,2015,6,0,6
Assam,Dima Hasao,2020,2020,6,6,0
Assam,Hailakandi,2019,2019,54,41,13
Assam,Lakhimpur,2017,2017,17,7,10
Assam,Tinsukia,2018,2017,1,0,1
Delhi,North East,2019,2019,193,160,33
Assam,Jorhat,2016,2016,9,0,9
Assam,Golaghat,2014,2015,1,1,0
Assam,Dhemaji,2019,2019,2,2,0
Delhi,South West,2019,2019,229,196,33
Assam,Baksa,2018,2015,2,0,2
Assam,Baksa,2020,2020,9,9,0
Haryana,Ambala,2017,2017,52,6,46
Assam,Tinsukia,2018,2018,61,45,16
Assam,Sonitpur,2019,2019,89,54,35
Haryana,Jind,2014,2014,11,0,11
Assam,Lakhimpur,2017,2019,1,1,0
Assam,Sivasagar,2016,2016,71,14,57
Assam,Sivasagar,2017,2016,1,0,1
Assam,Karbi Anglong,2019,2017,1,0,1
Delhi,Shahdara,2017,2016,1,1,0
Delhi,North,2014,2014,38,18,20
Assam,Dima Hasao,2018,2018,9,8,1
Haryana,Sonepat,2019,2019,76,57,19
Assam,Karimganj,2017,2017,5,2,3
Haryana,Jhajjar,2014,2014,22,0,22
Haryana,Kurukshetra,2018,2018,6,3,3
Haryana,Rewari,2018,2018,67,9,58
Assam,Nagaon,0   ,2013,1,0,1
Haryana,Kurukshetra,2019,2019,54,48,6
Assam,Nalbari,2020,2020,9,8,1
Delhi,South West,2020,2020,23,22,1
Assam,Sonitpur,2020,2020,19,11,8
Assam,Lakhimpur,2019,2019,49,20,29
Assam,Goalpara,2019,2019,66,56,10
Haryana,Jind,2015,2015,4,0,4
Assam,Kamrup,2017,2015,2,1,1
Assam,Nalbari,2018,2018,46,33,13
Assam,Kamrup,2020,2020,13,13,0
Assam,Kamrup,2016,2016,14,5,9
Assam,Morigaon,2017,2017,50,23,27
Assam,Darrang,2015,2015,4,0,4
Assam,Golaghat,2018,2018,51,19,32
Delhi,South West,2017,2016,1,1,0
Haryana,Faridabad,2018,2019,11,7,4
Delhi,South,2019,2018,3,3,0
Haryana,Gurugram,2017,2017,141,18,123
Assam,Udalguri,2017,2016,4,0,4
Haryana,Rohtak,2019,2019,51,46,5
Assam,Jorhat,0   ,2013,3,0,3
Assam,Kokrajhar,0   ,2014,3,0,3
Assam,Darrang,2019,2019,96,78,18
Delhi,New Delhi,2020,2020,19,19,0
Assam,Barpeta,2020,2020,43,42,1
Haryana,Hisar,2015,2015,3,0,3
Delhi,West,2018,2018,301,245,56
Delhi,South West,2016,2017,1,1,0
Delhi,Shahdara,2020,2020,25,25,0
Haryana,Gurugram,2018,2018,98,58,40
Haryana,Panchkula,2017,2017,26,11,15
Delhi,North,2018,2019,2,2,0
Haryana,Kurukshetra,2017,2017,47,0,47
Assam,Karbi Anglong,2017,2017,18,5,13
Assam,Darrang,2017,2017,7,4,3
Delhi,North East,2014,2014,14,8,6
Assam,Golaghat,2017,2017,49,23,26
Delhi,Central,2016,2016,161,104,57
Assam,Dhubri,2015,2015,7,1,6
Assam,Kamrup Metro,2014,2014,3,0,3
Haryana,Jind,2020,2020,13,13,0
Haryana,Faridabad,2015,2015,16,0,16
Haryana,Kaithal,2020,2020,8,8,0
Assam,Morigaon,2014,2014,10,0,10
Haryana,Sonepat,2016,2016,64,0,64
Assam,Udalguri,2015,2015,5,0,5
Delhi,West,2016,2016,259,146,113
Delhi,South,2018,2018,163,138,25
Assam,Chirang,2018,2014,1,1,0
Assam,Dhemaji,2018,2018,50,21,29
Assam,Kokrajhar,2020,2020,9,9,0
Delhi,West,2019,2019,231,209,22
Haryana,Bhiwani,2018,2018,1,1,0
Delhi,East,2016,2015,1,1,0
Assam,Nagaon,2017,2017,103,65,38
Assam,Kamrup,2014,2018,1,1,0
Assam,Jorhat,0   ,2014,1,0,1
Haryana,Kaithal,2017,2017,29,0,29
Delhi,South West,2013,2013,11,1,10
Delhi,South East,2013,2013,11,3,8
Haryana,Panchkula,2016,2016,18,3,15
Assam,Baksa,2018,2018,112,75,37
Assam,Karimganj,2016,2016,30,9,21
Delhi,Central,2019,2019,154,148,6
Delhi,South,2016,2014,1,1,0
Delhi,South East,2019,2019,151,137,14
Assam,Karbi Anglong,2016,2015,1,1,0
Assam,Bongaigaon,2015,2015,1,1,0
Delhi,North East,2016,2016,16,14,2
Haryana,Fatehabad,2020,2020,9,9,0
Assam,Karbi Anglong,2017,2018,3,2,1
Haryana,Sirsa,2014,2014,32,0,32
Assam,Barpeta,2018,2018,131,48,83
Delhi,North,2017,2018,3,3,0
Assam,Sivasagar,2017,2018,1,0,1
Delhi,New Delhi,2019,2019,105,94,11
Delhi,East,2012,2012,1,1,0
Delhi,South,2017,2018,2,1,1
Haryana,Rohtak,2020,2020,11,11,0
Assam,Udalguri,2014,2014,1,0,1
Haryana,Panipat,2019,2019,63,47,16
Assam,Barpeta,2016,2016,37,2,35
Assam,Dhemaji,0   ,2016,1,0,1
Haryana,Faridabad,2017,2017,144,1,143
Delhi,North,2019,2019,231,209,22
Delhi,North West,2019,2019,346,308,38
Delhi,New Delhi,2019,2020,1,1,0
Delhi,New Delhi,2018,2018,104,95,9
Delhi,South,2019,2020,2,2,0
Haryana,Kurukshetra,2016,2016,35,1,34
Assam,Karbi Anglong,2016,2016,13,4,9
Assam,Dhubri,2019,2019,104,70,34
Delhi,South West,2018,2018,330,221,109
Assam,Udalguri,2016,2014,1,0,1
Assam,Dhemaji,2015,2015,4,0,4
Assam,Bongaigaon,2017,2016,2,1,1
Assam,Cachar,0   ,2015,11,1,10
Assam,Nagaon,2020,2020,15,15,0
Assam,Dhubri,2017,2017,49,6,43
Haryana,Ambala,2015,2015,29,0,29
Assam,Cachar,2013,2013,2,0,2
Assam,Karimganj,2020,2020,7,7,0
Assam,Sivasagar,2020,2020,18,17,1
Delhi,South,2019,2019,156,151,5
Delhi,East,2019,2019,151,138,13
Assam,Cachar,2020,2020,20,20,0
Assam,Lakhimpur,2016,2016,30,15,15
Assam,Cachar,2014,2014,3,0,3
Delhi,North,2020,2020,33,33,0
Delhi,North,2015,2014,3,2,1
Assam,Darrang,2016,2016,14,3,11
Haryana,Panipat,2018,2018,27,11,16
Assam,Kamrup,2018,2018,105,55,50
Haryana,Kurukshetra,2015,2015,14,0,14
Haryana,Gurugram,2019,2019,159,128,31
Haryana,Fatehabad,2019,2019,53,38,15
Haryana,Yamunanagar,2015,2015,72,0,72
Delhi,North,2016,2015,1,0,1
Assam,Kokrajhar,0   ,2015,3,0,3
Delhi,West,2019,2020,3,3,0
Assam,Dhubri,2020,2020,14,13,1
Assam,Kamrup,2014,2014,9,1,8
Delhi,North East,2013,2013,3,1,2
Haryana,Jhajjar,2016,2016,34,0,34
Assam,Goalpara,2020,2020,8,8,0
Delhi,North,2013,2014,4,0,4
Haryana,Panchkula,2019,2019,23,18,5
Delhi,North West,2015,2015,9,8,1
Assam,Tinsukia,2019,2019,71,68,3
Assam,Kamrup,2016,2015,4,1,3
Assam,Hailakandi,2017,2017,15,2,13
Assam,Chirang,2015,2015,5,0,5
Delhi,West,2017,2016,1,0,1
Assam,Jorhat,2020,2020,17,17,0
Delhi,West,2016,2017,2,2,0
Assam,Dhubri,0   ,2015,12,0,12
Haryana,Sonepat,2015,2015,53,0,53
Assam,Tinsukia,0   ,2014,2,0,2
Assam,Morigaon,2019,2019,129,112,17
Assam,Dibrugarh,2015,2015,65,3,62
Assam,Udalguri,2016,2016,6,0,6
Haryana,Yamunanagar,2014,2014,5,0,5
Delhi,South,2014,2014,4,4,0
Assam,Dibrugarh,2015,2016,1,0,1
Haryana,Yamunanagar,2020,2020,3,3,0
Delhi,South West,2016,2016,118,68,50
Assam,Golaghat,2019,2019,89,53,36
Assam,Lakhimpur,2020,2020,13,6,7
Assam,Karbi Anglong,2018,2018,34,15,19
Assam,Hailakandi,2018,2018,27,11,16
Assam,Kamrup,2018,2017,1,1,0
Delhi,Central,2013,2013,97,3,94
Delhi,South East,2015,2015,39,35,4
Assam,Darrang,2018,2018,38,18,20
Assam,Kamrup,2018,2016,1,1,0
Haryana,Hisar,2019,2019,83,58,25
Assam,Kamrup Metro,2016,2016,19,10,9
Delhi,South West,2019,2020,4,4,0
Delhi,North,2015,2015,60,40,20
Assam,Nagaon,2014,2014,29,7,22
Delhi,West,2014,2015,1,1,0
Delhi,West,2020,2020,49,48,1
Assam,Udalguri,2017,2015,1,0,1
Delhi,South,2017,2016,4,3,1
Assam,Dibrugarh,2014,2014,17,0,17
Haryana,Panipat,2017,2017,50,6,44
Assam,Bongaigaon,2017,2017,16,1,15
Assam,Barpeta,2010,2019,1,1,0
Assam,Dima Hasao,2019,2019,5,4,1
Delhi,Shahdara,2017,2017,105,98,7
Assam,Karbi Anglong,2020,2020,18,18,0
Haryana,Sirsa,2019,2019,90,71,19
Haryana,Palwal,2020,2020,19,19,0
Haryana,Sonepat,2020,2020,11,11,0
Assam,Sivasagar,2019,2019,96,73,23
Assam,Cachar,2019,2019,73,49,24
Assam,Karbi Anglong,2014,2015,1,1,0
Haryana,Sonepat,2017,2017,55,3,52
Haryana,Faridabad,2019,2019,211,183,28
Haryana,Fatehabad,2017,2017,53,2,51
Delhi,North West,2013,2013,1,1,0
Delhi,South East,2019,2020,2,2,0
Assam,Tinsukia,2020,2020,14,14,0
Delhi,Central,2014,2014,77,10,67
Delhi,North,2013,2013,15,1,14
Assam,Sivasagar,2014,2014,32,1,31
Haryana,Rewari,2017,2017,30,0,30
Delhi,New Delhi,2017,2017,97,80,17
Assam,Karbi Anglong,2013,2013,5,4,1
Haryana,Ambala,2018,2018,68,27,41
Assam,Cachar,2017,2017,54,26,28
Assam,Cachar,2015,2015,9,0,9
Haryana,Palwal,2019,2019,93,78,15
Assam,Bongaigaon,2018,2018,13,1,12
Haryana,Kurukshetra,2020,2020,12,12,0
Delhi,South,2015,2015,80,76,4
Assam,Goalpara,0   ,2015,2,0,2
Assam,Tinsukia,2016,2016,3,0,3
Delhi,Central,2018,2018,164,138,26
Assam,Nagaon,2016,2016,24,16,8
Delhi,South West,2017,2018,3,2,1
Assam,Bongaigaon,2020,2020,16,16,0
Haryana,Sirsa,2020,2020,20,19,1
Assam,Sonitpur,2018,2018,146,56,90
Haryana,Jhajjar,2013,2013,1,0,1
Haryana,Jind,2016,2016,24,1,23
Assam,Goalpara,2016,2016,1,1,0
Delhi,South East,2016,2016,72,62,10
Haryana,Hisar,2020,2020,23,22,1
Delhi,North,2017,2017,268,194,74
Assam,Dhemaji,2017,2017,35,12,23
Delhi,North West,2018,2018,299,234,65
Haryana,Sonepat,2014,2014,20,0,20
Delhi,North West,2016,2017,1,1,0
Haryana,Rohtak,2015,2015,35,0,35
Haryana,Sirsa,2015,2016,1,0,1
Delhi,South,2013,2013,3,3,0
Assam,Nagaon,2018,2018,125,87,38
Assam,Sonitpur,0   ,2014,2,1,1
Haryana,Hisar,2016,2016,36,0,36
Assam,Kokrajhar,2019,2019,56,41,15
Assam,Chirang,2016,2016,8,1,7
Haryana,Panchkula,2018,2018,31,19,12
Assam,Bongaigaon,2019,2019,30,25,5
Assam,Goalpara,0   ,2014,1,1,0
Haryana,Ambala,2019,2019,75,52,23
Assam,Kamrup Metro,2020,2020,15,15,0
Haryana,Yamunanagar,2019,2019,3,3,0
Delhi,North East,2017,2017,43,37,6
Haryana,Rohtak,2017,2017,57,1,56
Assam,Kamrup,2017,2018,7,6,1
Assam,Sivasagar,2016,2017,1,1,0
Delhi,North West,2017,2017,231,159,72
Haryana,Kaithal,2018,2018,58,3,55
Assam,Karbi Anglong,2016,2019,1,1,0
Delhi,New Delhi,2019,2013,1,0,1
Haryana,Gurugram,2016,2016,52,3,49
Delhi,North East,2018,2018,117,88,29
Delhi,West,2013,2014,2,1,1
Assam,Barpeta,2019,2019,198,128,70
Assam,Jorhat,2018,2018,59,17,42
Assam,Kamrup,2015,2015,10,4,6
Assam,Bongaigaon,2015,2016,2,1,1
Assam,Barpeta,2014,2014,3,0,3
Assam,Golaghat,2016,2016,79,27,52
Haryana,Gurugram,2020,2020,15,15,0
Haryana,Yamunanagar,2018,2018,3,1,2
Assam,Kamrup Metro,2015,2015,11,0,11
Delhi,South East,2017,2017,135,118,17
Haryana,Jhajjar,2017,2017,42,1,41
Delhi,North East,2015,2015,22,21,1
